cccccccccccccccc
c............t.c
c..............c
c..............c
c..............c
c..............c
c..ccc....ccc..c
c.c......c.....c
c.c..c...c..c..c
c..ccc....ccc..c
c..............c
c..............c
c..............c
c..............c
c.h............c
cccccccccccccccc 