oooooooooooooooo
o..............o
o..............o
o............b.o
oooooo...ooooooo
o..............o
o..............o
o.....b........o
o.....ooooo....o
o..............o
ooo............o
ob......o......o
ooooooooo......o
o............c.o
o.h.........oooo
oooooooooooooooo 