oooooooooooooooo
o..............o
o..............o
oe.............o
ooooo..........o
o..............o
o.......oooooooo
o..............o
o....e.........o
o...ooooooo....o
o..............o
oe.............o
oooooo.........o
o..............o
oh............eo
oooooooooooooooo