oooooooooooooooo
o......t.......o
o......c.......o
o....ooooooo...o
o..............o
o..............o
o.........b....o
o...b..........o
o..............o
o..............o
o..............o
o.....oooooolllo
o.....h........o
o.....ooo......o
o...........e..o
ollllloooooooooo 