oooooooooooooooo
oooo.......t..co
o........llllllo
o..............o
o..............o
o..............o
o......e.......o
ollllllllllll..o
o..............o
o..............o
o......ooo.....o
o..............o
o..llllllllllllo
o..............o
o.h............o
oooooooooooooooo 