llllllllllllllll
i..............i
i.e.......b....i
ib.............i
i....i...i.....i
illiio...oiiilli
i..............i
i..............i
i..e...e.......i
iiiiiiiiiill...i
i.b............i
i..............i
i...h.iiiill...i
i..ooo.........i
i............t.i
iiilllllllllllll 