oooooooooooooooo
o..............o
o..............o
o..............o
o..............o
o..............o
o.b............o
ooooo..........o
o..............o
o..............o
o...........c..o
o........ooooooo
o..............o
o..............o
o..h...........o
oooooooosslliioo