llllllllllllllll
l..............l
l.l....t..b....l
l....l.......l.l
l.b......l.....l
l...l..........l
ll.........l...l
l....b.l.b....lo
l..l........b..l
l.......b..l...l
l..............l
oll..l.........l
l......b.l...l.l
l..............l
lh.............l
oiillllllllllllo