oooooooooooooooo
oc.............o
o..............o
olllliii...t...o
o..............o
o...b......b...o
o..sss....sss..o
o..lll....lll..o
o..............o
o..............o
o..............o
o..............o
o......h.......o
o..ssssosssss..o
o.e............o
oooooooooooooooo