llllllllllllllll
o..............o
o..............o
o............b.o
oooooo...ooooooo
o...........lllo
o..............o
o...ee.........o
o...ooo........o
o..........l...o
o..........o...o
oc.........l...o
oooololololo...o
o..............o
o.h............o
olollllllllllllo
